1111111111111
1E10000000CC1
10S0011111001
1P0011E000001
1111111111111
