1111111111111
1E100000000C1
1CC0011111001
1P0011C000001
1111111111111
