1111111111111
1001000000CC1
1000011111001
1P0011E0000S1
1111111111111
