1111111111111111111111111
1111111110001100000001111
1111111100011100100001111
1111111000111101100001111
1111110001111111100011111
1111100011111111000111111
1111000111111110001111111
111100E000000100011111111
1110000000000100011001111
111100000C00C00P100001111
1111111111000111111111111
1111111111000111111111111
1111111111111111111111111
