111111111111111
110000E00000P01
111110000001111
100CS0010000C11
111111111111111