111111111111111
1100000000100E1
111110C00001111
1000000000000P1
111111111111111