11111111111
110000CCPC1
11100001001
10ES0000001
11111111111