111111111111111
110000011111111
111110000001111
10C0000000000P1
111111111111111