111111111111111
110000E00000001
111110000001111
100C00010000011
111111111111111