111111111111111
110000E00000P01
111110000001111
100C00010000P11
111111111111111