1111111111111111111111111
1CS1111111111110S00000S01
1000SS00SSC11100000S00001
10S00000S00S11001111111C1
10S0SSS0000011000110E1111
101C100010100000000010P01
1011101010111001110000001
100000000000000C111111111
1111111111111111111111111