1111111111111
1000000P000S1
10CS001111001
100E10C0000C1
1111111111111