111111111111111111111111
10E000111111100C00010111
100001111110000011001111
100C01110S0000000110S111
100001111110000011001111
100C01110000000001100111
100001111110000011001111
100C01110000000001100111
10000000011100C001100P11
100000111111S00001101111
11000C01110000C000111111
111111111111111111111111